# 4 x 4 - start 0,0
" 
1,1,1,1
1,1,1,1
1,1,1,1
1,1,1,3
"

# 5 x 5 - start 1,1 
" 
1,1,1,1,1
1,1,1,3,1
1,1,2,1,1
1,1,2,3,1
1,3,1,3,1
"

# 6 x 6 - start 5, 5
" 
1,1,1,1,2,1
1,3,1,3,1,1
1,1,2,2,1,1
1,1,2,1,1,1
1,1,2,2,1,1
1,3,1,1,3,1
"

